   ############################
      #           #           #
#  ####  #  ####  #  #  ####  #
#     #  #  #     #  #     #  #
####  ##########  #######  ####
#  #  #           #        #  #
#  #  #######  #######  #  #  #
#        #           #  #  #  #
#######  #  #  ####  #  #  #  #
#     #     #  #        #     #
#  #  #  #############  #  ####
#  #              #     #     #
##########  #  ####  ##########
#     #     #  #  #           #
#  #  #  #######  #######  ####
#  #  #  #           #        #
####  #  ####  ####  ####  ####
#  #  #  #        #        #  #
#  #  ####  ####  ##########  #
#              #              
############################  